############################}
#............##............#}
#.####.#####.##.#####.####.#}
#.####.#####.##.#####.####.#}
#.####.#####.##.#####.####.#}
#..........................#}
#.####.##.########.##.####.#}
#.####.##.########.##.####.#}
#......##....##....##......#}
######.#####.##.#####.######}
.....#.#####.##.#####.#.....}
.....#.##..........##.#.....}
.....#.##.###..###.##.#.....}
######.##.#......#.##.######}
..........#......#..........}
######.##.#......#.##.######}
.....#.##.########.##.#.....}
.....#.##..........##.#.....}
.....#.##.########.##.#.....}
######.##.########.##.######}
#............##............#}
#.####.#####.##.#####.####.#}
#.####.#####.##.#####.####.#}
#...##................##...#}
###.##.##.########.##.##.###}
###.##.##.########.##.##.###}
#......##....##....##......#}
#.##########.##.##########.#}
#.##########.##.##########.#}
#..........................#}
############################}
